
NO    ./textures/wall1.xpm

SO ./textures/wall3.xpm

EA ./textures/wall4.xpm

C  0, 136	,  227

F   129,78,32

WE ./textures/wall2.xpm

111111111111
100000000011
100000011011
100011111111
100000000001
10N0111111111111111
100000000001
111111111111

