F   0,3,22

NO 	r
SO ./path_to_the_south_texture
WE ./path_to_the_west_texture

EA ./path_to_the_east_texture

C 14,		3	,  3


111111111111
100000000011
1N0000000011
100010001011
1001 1000011
100010000001
111111111011
111111111111
