
NO 	./textures/wall1.xpm
SO ./path_to_the_south_texture
WE .    

EA ./path_to_the_east_texture

C 84,		136	,  227
F   129,78,32


111111111111
100000000011
100000011N11
100011111111
100000000001
100011111111
100000000001
100011111111
100000000001
100011111111
100000000001
100011111111
100000000001
100011111111
100000000001
111111111111
