
NO 	./textures/wall1.xpm
SO ./path_to_the_south_texture
WE .    

EA ./path_to_the_east_texture

C 84,		136	,  227
F   129,78,32


111111111111
100000000011
100000010011
100011111111111
100000000000001111111
1000000100110101
100000000011001111
1000N0000000001
100000000000001
100000000000001
100000000000001
100000000000001
100000000000001
100000000000001
11111111111111
