
NO 	./textures/wall1.xpm
SO ./path_to_the_south_texture
WE .    

EA ./path_to_the_east_texture

C 84,		136	,  227
F   129,78,32


111111111111
1000000S0011
100000000011
100011111111111
1000000000000011
1000000100110101
1000000000110011
100000000000001
1111111110111111
111111111111
