
NO 	./textures/wall1.xpm
SO ./textures/wall3.xpm
WE ./textures/wall2.xpm

EA ./textures/wall4.xpm

C 84,		136	,  227
F   129,78,32


111111111111
100000000011
100000011011
100011111111
100000000001
100011111111
100000000001
100011111111
100000000001
100011111111
100000000001
10N011111111
100000000001
100011111111
100000000001
111111111111
